111111111111111111111
100000000000000000111
1000000C0C0000C0000P1
100111111111111111111
100000000C00000000001
111111111111111111001
100C00010001000100001
100000010001000100001
100001000100010001001
1E0001000100010001001
111111111111111111111